#########################
#.......................#
#.......................#
#.....s.................#
#...........#....#......#
#...........###s##......#
#...........#....#......#
#...........#....#......#
####################..###
                   #..#
                   #..#
                  ##..##
 #########       #......#
 #.......#       #......#
 #...s...#       #......#
 #.......#########...s..#
 #......................#
 #.@.....#########......#
 #.......#       #......#
 #########        ######